test.png
500 20
6 6
0 0 0 0 0 0
0 0 0 0 0 0
1 1 0 1 1 1
0 1 0 1 0 0
0 1 0 1 0 0
0 1 1 1 0 0
0 2
grunt 100 grunt 1000
