Levels/Level2_BG.png
level_1.ogg
150 3
8 13
0 0 0 1 0 0 0 0 0 0 0 1 0
0 0 0 1 0 1 1 1 1 1 0 1 0
0 0 0 1 0 1 0 0 0 1 0 1 0
0 1 1 1 0 1 1 1 0 1 0 1 0
0 1 0 0 0 0 0 1 0 1 0 1 0
0 1 1 1 0 1 1 1 0 1 0 1 0
0 0 0 1 0 1 0 0 0 1 0 1 0
0 0 0 1 1 1 0 0 0 1 1 1 0
3,-1 3,3 1,3 1,5 3,5 3,7 5,7 5,5 7,5 7,3 5,3 5,1 9,1 9,7 11,7 11,-1
Badger 4 RedBadger 7
RedBadger 5 BlueBadger 7 RedBadger 7
BlueBadger 20
RedBadger 7 BlueBadger 30 RedBadger 12