test.png
5000 20
8 13
0 0 0 0 0 0 0 0 0 0 0 0 1
0 0 0 0 0 0 0 0 0 0 0 0 1
1 1 1 1 0 0 0 0 0 0 0 0 1
0 0 0 1 0 0 1 1 1 1 0 0 1
0 1 1 1 0 0 1 0 0 1 0 0 1
0 1 0 0 0 0 1 0 0 1 0 0 1
0 1 1 0 0 1 1 0 0 1 0 0 1
0 0 1 1 1 1 0 0 0 1 1 1 1
7 0,2 3,2 3,5 1,5 1,7 2,7 2,8 5,8 5,7 6,7 6,3 9,3 9,7 12,7 12,0
Badger 4000 Badger 6000 Badger 9000